111111111
10000001
10000001
11111111