11111111
10000001
00000001
11111111