11111111
10E00E01
10P00PC1
11111111