11111111
100C0011
1000P0E1
11111111